%%%%%%%%%%%%%%%%%%%%
%                 P%
%%%%%%%%% %%%%%%%%%%
%%%%%%%%% %%%%%%%%%%
%%%%%%%%% %%%%%%%%%%
%%%%%%%%% %%%%%%%%%%
%%%%%%%%% %%%%%%%%%%
%%%%%%%%% %%%%%%%%%%
%.                 %
%%%%%%%%%%%%%%%%%%%%