%%%%%%%%%%%%%%%%%%%%%
%      .......      %
%     .........     %
%    ...........    %
%   .............   %
%  .......P.......  %
%   .............   %
%    ...........    %
%     .........     %
%      ......       %
%%%%%%%%%%%%%%%%%%%%%